00010100100011010001
10010111000110101000
00001100100000000000
00000011100110100111
10000010111000011000
00010100000010000001
11100001101000101010
00000000000111000101
01100010100000010000
00001010110101001000
