00000000000100000010
10010010001000000100
10101000001000001000
00100000000000100100
00110000101000100001
00011010000000101010
10010101000010111100
01000010100010001000
00000011000110100010
00000001110001010010
