01010100000100000000
10000100000001010010
01001000110000011110
00001000011001000111
00100100000110011110
00100001000110110101
11011001000010000000
11110000100000010000
10000000000110010010
00000101000010000100
